115,52
136,45
140,36
; 
WWWWWWWWWWWWWWWWWWWWWWWW
WEEEEEEWEEEEEEEEWWWWWEEW
WEEEEEWEWEEEEEEEEEWEEEEW
WEEEEWEEEWEEEEEEEEWEEEEW
WEEEETWWWWEEEEEEEETEEEEW
WEEEWEEEEETEEEEEEEWEEEEW
WEEWEEEEEEEWEEEEWWWWWEEW
WWWWWWWWWWWWWWWWWWWWWWWW