21,63
305,83
246,42
25,185
;
WWWWWWWWWWWWWWWWWWWW
WEEEEEEEEEEEEEEEEEEW
WEEEEWWWWWWWWWEEEEEW
WEEEEEEEEWEEEEEEEEEW
WEEEEEEEEWEEEEEEEEEW
WEEEEEEEEWEEEEEEEEEW
WEEEEEEEEWEEEEEEEEEW
WEEEEEEEEWEEEEEEEEEW
WEEEEEEEEWEEEEEEEEEW
WEEEEEEEEWEEEEEEEEEW
WEEEEEEEEWEEEEEEEEEW
WEEEEWWWWWWWWWEEEEEW
WEEEEEEEEEEEEEEEEEEW
WWWWWWWWWWWWWWWWWWWW
