11,36
57,13
; 
WWWWWWWWWW
WEEEEEEEEW
WWEWEWEEEW
WEEWTEEEEW
WEEEWWWWEW
WEEEEEEEEW
WWWWWWWWWW
