9,46
17,38
; 
WWWWWWWW
WEEEEEEW
WETTTTEW
WETEEEEW
WETEEEEW
WEEEEEEW
WWWWWWWW
