15,75
19,71
149,107
157,26
; 
WWWWWWWWWWWWWW
WEEEEEEEETTEEW
WEWWWTEEETTEEW
WEWEEEEEETEEEW
WEWEWWWEEEEWWW
WEWEEEWEEETTTW
WEWWWWWEEEEEEW
WEEEEEEWWEWWEW
WWWWWETEEWEETW
WEEEEEEWEEEWEW
WETWWWTEWEWEEW
WEEEEETTETETTW
WWWWWWWWWWWWWW