37,82
21,81
112,52
23,83
; 
WWWWWWWWWWWWWWW
WEEEEEETEEEEEEW
WEEEEETETEEEEEW
WEEEETEEETEEEEW
WEEEETTTTTEEEEW
WEEETEEEEETEEEW
WEETEEEEEEETEEW
WEETEEEEEEETEEW
WWWWWWWWWWWWWWW
