11,36
57,13
; 
WWWWWWWWWW
WEEEEEEEEW
WEEEWWEEEW
WWEETEEEEW
WEEEWEWEWW
WEEWWEEEEW
WWWWWWWWWW
