477,62
62,41
482,199
; 
WWWWWWWWWWWWWWWWWWWWWWWWWWWWWWWWWW
WEEEEEEEEEEEEEETTEEEEEEEEETWEEEEEW
WEEETETEEEWEEETEEEEEEEEETWTWTTTEEW
WEEEEETETETEETETEEETWEEEEEEWTEEEEW
WEEEETEEETWEEEETETEEEEEEETTWWEEEEW
WEEEETTTTTWEEETETEETWEEETTTTTEEEEW
WEEETEEEEEWEEEETETEEETWETTTTTEEEEW
WEETEEETETWEEEEEEEETWTEETTTTTEEEEW
WEETEEEEEEWTEWEETETEEEETWTTTTTTEEW
WEEEEEEEEEWEEEWEETETWETETTTTTEEEEW
WEEEEEEEEEWEEEEWETETEEEETWTTTEEEEW
WEEEEETWEEWEEEEEWWETEETEETEEEEEEEW
WEEEEEEEEEWETWEEEEWTEETEEEEEEEEEEW
WEEEWWWWWWWWWWWWTEWTEETEEEEEEEEEEW
WEEEEEEEEEEEEEEETEWTETWEEEEEEEEEEW
WWWWWWWWWWWWWWWWWWWWWWWWWWWWWWWWWW