477,62
62,473
111,471
; 
WWWWWWWWWWWWWWWWWWWWWWWWWWWWWWWWWWW
WEEEEEEEEEEEEEEEEEEEEEEEEEEEEEEEEEW
WEEEEEEEEETEEEEEEEEEEEEETEEEEEEEEEW
WEEEEEEEEEWEEEEEEEEEEEEEWEEEEEEEEEW
WEEEEEEEEEEWEEEEEEEEEEEWEEEEEEEEEEW
WEEEEEEEEEEWEEEEEEEEEEEWEEEEEEEEEEW
WEEETEEEEEEEWEEEEEEEEEWEEEEEEETEEEW
WEEEEWWWEEEEEWEEEEEEEWEEEEEWWWEEEEW
WEEEEEEEWWWEEEWETETEWEEEWWWEEEEEEEW
WEEEEEEEEEEWWEEWWWWWEEWWEEEEEEEEEEW
WEEEEEEEEEEEEWWWWTWWWWEEEEEEEEEEEEW
WEEEEEEEEEEEWEEWEWEWEEWEEEEEEEEEEEW
WEEEEEEEEEEWEEWEWWWEWEEWEEEEEEEEEEW
WEEEEEEEEWWEEWEWETEWEWEEWWEEEEEEEEW
WEEEEEWWWEEEWEEEWEWEEEWEEEWWWEEEEEW
WEEEETEEEEEWEEEEEEEEEEEWEEEEETEEEEW
WEEEEEEEEEEWEEEEEEEEEEEWEEEEEEEEEEW
WEEEEEEEEEWEEEEEEEEEEEEEWEEEEEEEEEW
WEEEEEEEEEWEEEEEEEEEEEEEWEEEEEEEEEW
WEEEEEEEEETEEEEEEEEEEEEETEEEEEEEEEW
WEEEEEEEEEEEEEEEEEEEEEEEEEEEEEEEEEW
WWWWWWWWWWWWWWWWWWWWWWWWWWWWWWWWWWW