227,95
26,155
159,44
;
WWWWWWWWWWWWWWWWWWWWWWWWW
WEEEEEEEEEEEEEEEEEEEEEEEW
WEEEEEETEEEEEEEEETTTTTEEW
WEEEEETETEEEEEEEEEETEEEEW
WEEEETEEETEEEEEEEEETEEEEW
WEEEETTTTTEEEEEEEEETEEEEW
WEEETEEEEETEEEEEEEETEEEEW
WEETEEEEEEETEEEEEEETEEEEW
WEETEEEEEEETEEEEETTTTTEEW
WEEEEEEEEEEEEEEEEEEEEEEEW
WWWWWWWWWWWWWWWWWWWWWWWWW