51,36
45,13
; 
WWWWWWWWWW
WEEEEEEEEW
WEEEWWEEEW
WWEETEEEEW
WEEEWEWEWW
WEEWWEEEEW
WWWWWWWWWW
