18,66
52,32
;
WWWWWWWWWWWWWWWWW
WEEEEETEEEEEEEEEW
WETEEEEEEWETEETEW
WEEETEEETEEEEEEEW
WEEEETEEETEEEETEW
WWWWWWWWWWWWWWWWW
