8,26
19,24
; 
WWWWWWW
WEEEEEW
WEEETEW
WEEEWEW
WWWWWWW
