6,18
16,6
; 
WWWWW
WEEEW
WEETW
WEEEW
WWWWW
