137,37
182,45
329,184
; 
WWWWWWWWWWWWWWWWWWWWWWWW
WEEEEEEEEEEEEEEETEEEEEEW
WEWWWWWWWWWWWWWWWWWWWWEW
WEWEEEEEEEEEEEEEEEEEEWEW
WEEEWWWWWWWWWWWWWWWWEWEW
WEWEWEEEEEEEEEEEEEEWEWEW
WEWEWEWEWWWWWWWWWWEWEWEW
WEWEWEWEEEEEEEEEEWEWEWEW
WEWEWEWWWWWWWWWWWWEWEWEW
WEWEWEEEEEEEEEEEEEEWEWEW
WEWEWWWWWWWWWWWWEWWWEWEW
WEWEEEEEEEETEEEEEEEEEWEW
WEWWWWWWWWWWWWWWWWWWWWEW
WEEEEETETETETETETEEEEEEW
WWWWWWWWWWWWWWWWWWWWWWWW