199,40
198,41
115,152
;
WWWWWWWWWWWWWWWWWWWWWWWW
WEEEEEEEEEEEEEEEEEEEEEEW
WEEEEEETEEEEEEEETTTTTEEW
WEEEEETETEEEEEEEEETEEEEW
WEEEETEEETEEEEEEEETEEEEW
WEEEETTTTTEEEEEEEETEEEEW
WEEETEEEEETEEEEEEETEEEEW
WEETEEEEEEETEEEEEETEEEEW
WEETEEEEEEETEEEETTTTTEEW
WEEEEEEEEEEEEEEEEEEEEEEW
WWWWWWWWWWWWWWWWWWWWWWWW